id,district,locality,families,households,population,male,female
1,Taplejung,Aathrai Tribeni  ,2869,2735,12288,6005,6283
2,Taplejung,Maiwakhola  ,2275,2178,10365,5264,5101
3,Taplejung,Meringden  ,2683,2528,12040,6181,5859
4,Taplejung,Mikwakhola  ,1862,1792,7991,4000,3991
5,Taplejung,Phaktanglung  ,2864,2700,11925,6239,5686
6,Taplejung,Phungling ,7306,5888,28786,14160,14626
7,Taplejung,Sidingba  ,2604,2484,10981,5593,5388
8,Taplejung,Sirijangha  ,3329,3197,14186,7227,6959
9,Taplejung,Pathivara Yangwarak  ,2738,2637,11797,5855,5942
10,Panchthar,Falelung  ,4940,4773,20531,10211,10320
11,Panchthar,Falgunanda  ,5293,4968,21253,10417,10836
12,Panchthar,Hilihang  ,4878,4647,20537,10160,10377
13,Panchthar,Kummayak  ,3199,3012,13020,6532,6488
14,Panchthar,Miklajung  ,5509,5163,21328,10535,10793
15,Panchthar,Phidim ,12433,10442,48713,23963,24750
16,Panchthar,Tumbewa  ,2752,2636,11063,5644,5419
17,Panchthar,Yangwarak  ,3964,3765,16828,8509,8319
18,Ilam,Chulachuli  ,5624,5533,22856,11215,11641
19,Ilam,Deumai ,7907,7535,31531,15807,15724
20,Ilam,Fakphokthum  ,4923,4748,20004,9800,10204
21,Ilam,Illam ,13395,11943,50455,24781,25674
22,Ilam,Maijogmai  ,4957,4881,19295,9686,9609
23,Ilam,Mai ,7966,7844,30988,15126,15862
24,Ilam,Mangsebung  ,3891,3793,16897,8602,8295
25,Ilam,Rong  ,4715,4650,17555,8739,8816
26,Ilam,Sandakpur  ,4031,3937,15460,7840,7620
27,Ilam,Suryodaya ,14149,13463,55457,27922,27535
28,Jhapa,Arjundhara ,20978,18995,84429,40591,43838
29,Jhapa,Barhadashi  ,9053,8665,37916,17952,19964
30,Jhapa,Bhadrapur ,17385,16032,70823,33988,36835
31,Jhapa,Birtamod ,29861,23039,117355,57136,60219
32,Jhapa,Buddhashanti  ,13276,12518,52911,25276,27635
33,Jhapa,Damak ,27725,22000,107410,51118,56292
34,Jhapa,Gauradhaha ,14845,14137,60598,28782,31816
35,Jhapa,Gauriganj  ,8712,8069,36058,17089,18969
36,Jhapa,Haldibari  ,7894,7621,33054,15831,17223
37,Jhapa,Jhapa  ,8554,8003,39372,19131,20241
38,Jhapa,Kachankawal  ,10200,9260,42386,20024,22362
39,Jhapa,Kamal  ,13356,12335,53710,25739,27971
40,Jhapa,Kankai ,13553,12419,53088,25557,27531
41,Jhapa,Mechinagar ,32710,29865,131520,64410,67110
42,Jhapa,Shivasataxi ,18036,17031,73460,34872,38588
43,Morang,Belbari ,20662,18945,81837,38460,43377
44,Morang,Biratnagar Metropolitian City,57383,45204,244750,122769,121981
45,Morang,Budhiganga  ,12455,10768,51640,25472,26168
46,Morang,Dhanpalthan  ,9935,8528,45204,22136,23068
47,Morang,Gramthan  ,9483,8660,36500,17889,18611
48,Morang,Jahada  ,9868,8489,47836,24262,23574
49,Morang,Kanepokhari  ,10760,10271,43177,20441,22736
50,Morang,Katahari  ,10522,9370,48633,24414,24219
51,Morang,Kerabari  ,8809,8184,34725,16768,17957
52,Morang,Letang ,9304,8758,38675,18473,20202
53,Morang,Miklajung  ,8390,7969,33315,16074,17241
54,Morang,Patahrishanishchare ,18191,16621,72689,34263,38426
55,Morang,Rangeli ,13339,11903,57814,28238,29576
56,Morang,Ratuwamai ,14624,13768,61355,29091,32264
57,Morang,Sundarharaicha ,30219,26677,121305,57858,63447
58,Morang,Sunwarshi ,12889,11401,56169,27092,29077
59,Morang,Uralabari ,17818,15899,71562,33827,37735
60,Sunsari,Barahchhetra ,21961,20781,91891,43178,48713
61,Sunsari,Barju  ,8034,6867,36533,18571,17962
62,Sunsari,Bhokraha Narsing  ,9299,8155,49371,24501,24870
63,Sunsari,Dewanganj  ,7814,6526,39367,19710,19657
64,Sunsari,Dharan Sub-Metropolitian City,43815,34834,173096,82683,90413
65,Sunsari,Duhabi ,15415,12410,67051,33448,33603
66,Sunsari,Gadhi  ,8751,7664,39478,19426,20052
67,Sunsari,Harinagar  ,8765,7630,49501,24459,25042
68,Sunsari,Inaruwa ,16931,15044,75920,37273,38647
69,Sunsari,Itahari Sub-Metropolitian City,50743,40207,198098,94308,103790
70,Sunsari,Koshi  ,9377,7634,48768,24550,24218
71,Sunsari,Ramdhuni ,15969,14025,63378,29980,33398
72,Dhankuta,Chaubise  ,4493,4233,17914,8764,9150
73,Dhankuta,Chhathar Jorpati  ,4143,3932,16477,7976,8501
74,Dhankuta,Dhankuta ,9803,8087,36156,17387,18769
75,Dhankuta,Shahidbhumi  ,4109,4079,17784,8807,8977
76,Dhankuta,Mahalaxmi ,5434,5251,22196,10862,11334
77,Dhankuta,Pakhribas ,4881,4644,19256,9247,10009
78,Dhankuta,Sangurigadhi  ,5025,4860,19601,9626,9975
79,Terhathum,Aathrai  ,4427,4223,18210,8996,9214
80,Terhathum,Chhathar  ,3509,3390,14245,6960,7285
81,Terhathum,Laligurans ,3773,3439,15418,7482,7936
82,Terhathum,Menchayam  ,1708,1620,6698,3272,3426
83,Terhathum,Myanglung ,4934,4163,19078,9347,9731
84,Terhathum,Phedap  ,3671,3517,15236,7506,7730
85,Sankhuwasabha,Bhotkhola  ,1717,1677,6509,3256,3253
86,Sankhuwasabha,Chainpur ,6690,6201,27078,13210,13868
87,Sankhuwasabha,Chichila  ,1672,1583,6720,3351,3369
88,Sankhuwasabha,Dharmadevi ,4071,3906,16300,7890,8410
89,Sankhuwasabha,Khandbari ,9333,8151,36102,17967,18135
90,Sankhuwasabha,Madi ,3288,3169,13428,6584,6844
91,Sankhuwasabha,Makalu  ,3485,3309,13492,6920,6572
92,Sankhuwasabha,Panchakhapan ,4010,3897,16391,8060,8331
93,Sankhuwasabha,Sabhapokhari  ,2533,2362,10005,5012,4993
94,Sankhuwasabha,Silichong  ,2501,2427,10432,5223,5209
95,Bhojpur,Aamchowk  ,3566,3472,15237,7517,7720
96,Bhojpur,Arun  ,3582,3487,14853,7247,7606
97,Bhojpur,Bhojpur ,6775,6078,26126,12676,13450
98,Bhojpur,Hatuwagadhi  ,4040,3987,16302,8030,8272
99,Bhojpur,Pauwadungma  ,2933,2866,12170,5851,6319
100,Bhojpur,Ramprasad Rai  ,3700,3627,15632,7741,7891
101,Bhojpur,Salpasilichho  ,3019,2972,12229,6008,6221
102,Bhojpur,Shadananda ,7450,7139,29777,14681,15096
103,Bhojpur,Temkemaiyung  ,3855,3773,15491,7611,7880
104,Solukhumbu,Thulung Dudhkoshi  ,4672,4568,18459,9225,9234
105,Solukhumbu,Maapya Dudhkoshi  ,3142,3102,12746,6422,6324
106,Solukhumbu,Khumbupasanglahmu  ,2611,2341,9226,4737,4489
107,Solukhumbu,Likhupike  ,1255,1255,5264,2588,2676
108,Solukhumbu,Mahakulung  ,2909,2885,11971,5921,6050
109,Solukhumbu,Nechasalyan  ,2662,2631,10828,5325,5503
110,Solukhumbu,Solududhakunda ,6830,6335,27013,13700,13313
111,Solukhumbu,Sotang  ,2321,2271,9261,4711,4550
112,Okhaldhunga,Champadevi  ,4040,3977,16528,8146,8382
113,Okhaldhunga,Chisankhugadhi  ,3346,3321,13761,6711,7050
114,Okhaldhunga,Khijidemba  ,3496,3461,15867,7926,7941
115,Okhaldhunga,Likhu  ,3189,3125,11930,5912,6018
116,Okhaldhunga,Manebhanjyang  ,4855,4795,19883,9626,10257
117,Okhaldhunga,Molung  ,4173,4116,16944,8464,8480
118,Okhaldhunga,Siddhicharan ,7173,6957,27977,13554,14423
119,Okhaldhunga,Sunkoshi  ,4417,4359,18024,8983,9041
120,Khotang,Ainselukhark  ,3506,3421,13581,6713,6868
121,Khotang,Barahapokhari  ,2591,2540,11461,5713,5748
122,Khotang,Diprung Chuichumma  ,3848,3780,16549,8139,8410
123,Khotang,Halesi Tuwachung ,6149,5948,27274,13434,13840
124,Khotang,Jantedhunga  ,2765,2713,12066,5934,6132
125,Khotang,Kepilasagadhi  ,3346,3237,13339,6583,6756
126,Khotang,Khotehang  ,4149,4056,16952,8417,8535
127,Khotang,Rawa Besi  ,2724,2646,11218,5424,5794
128,Khotang,Diktel Rupakot Majhuwagadhi ,10719,9775,43295,21345,21950
129,Khotang,Sakela  ,2307,2276,9605,4819,4786
130,Udayapur,Belaka ,12170,11633,51458,24631,26827
131,Udayapur,Chaudandigadhi ,12857,12162,53537,25389,28148
132,Udayapur,Katari ,14296,12843,60168,29250,30918
133,Udayapur,Rautamai  ,4586,4434,20418,10017,10401
134,Udayapur,Limchungbung  ,2257,2229,9789,4837,4952
135,Udayapur,Tapli  ,2884,2843,13377,6648,6729
136,Udayapur,Triyuga ,25928,23138,104375,49514,54861
137,Udayapur,Udayapurgadhi  ,6810,6650,28929,14093,14836
138,Saptari,Agnisair Krishna Savaran  ,6726,6092,32047,15735,16312
139,Saptari,Balan Bihul  ,5004,3770,24059,12169,11890
140,Saptari,Rajgadh  ,6942,5687,32975,16564,16411
141,Saptari,Bishnupur  ,5780,5007,28072,14230,13842
142,Saptari,Bode Barsain ,9854,7988,46343,23092,23251
143,Saptari,Chhinnamasta  ,6373,4747,30664,15416,15248
144,Saptari,Dakneshwori ,10094,7954,48314,24055,24259
145,Saptari,Hanumannagar Kankalini ,11130,8680,51926,26330,25596
146,Saptari,Kanchanrup ,12662,10277,58882,28949,29933
147,Saptari,Khadak ,11355,9432,54193,26139,28054
148,Saptari,Mahadeva  ,6522,5322,31048,15737,15311
149,Saptari,Rajbiraj ,15121,13062,71946,36942,35004
150,Saptari,Rupani  ,6963,5801,30064,14806,15258
151,Saptari,Saptakoshi  ,5305,4624,23891,11632,12259
152,Saptari,Shambhunath ,8824,7388,39423,18943,20480
153,Saptari,Surunga ,10611,8979,49668,23899,25769
154,Saptari,Tilathi Koiladi  ,6874,5366,34257,17459,16798
155,Saptari,Tirahut  ,5151,4148,23987,12086,11901
156,Siraha,Arnama  ,5208,4231,28137,13741,14396
157,Siraha,Aurahi  ,5891,4092,27194,13669,13525
158,Siraha,Bariyarpatti  ,5965,4475,29859,14876,14983
159,Siraha,Bhagawanpur  ,4650,3553,23324,11544,11780
160,Siraha,Bishnupur  ,4870,3821,22796,11303,11493
161,Siraha,Dhangadhimai ,11133,9657,54244,26617,27627
162,Siraha,Golbazar ,13214,10853,65263,32258,33005
163,Siraha,Kalyanpur ,12491,9869,59986,28789,31197
164,Siraha,Karjanha ,8440,6696,38940,18965,19975
165,Siraha,Lahan ,21488,17832,102955,51063,51892
166,Siraha,Laxmipur Patari  ,6666,5235,31103,14912,16191
167,Siraha,Mirchaiya ,12905,10496,60086,30054,30032
168,Siraha,Naraha  ,4419,3787,23656,12319,11337
169,Siraha,Nawarajpur  ,4268,3214,20832,10214,10618
170,Siraha,Sakhuwanankarkatti  ,4263,3223,20951,10230,10721
171,Siraha,Siraha ,19810,15310,96543,47306,49237
172,Siraha,Sukhipur ,8912,7192,42547,21189,21358
173,Dhanusa,Aaurahi  ,4846,4036,24338,11773,12565
174,Dhanusa,Bateshwor  ,4766,3903,21473,10670,10803
175,Dhanusa,Bideha ,7764,6156,37881,18446,19435
176,Dhanusa,Chhireshwornath ,10826,8913,53031,26708,26323
177,Dhanusa,Dhanauji  ,4683,3704,21960,10481,11479
178,Dhanusa,Dhanusadham ,10959,9216,53035,26337,26698
179,Dhanusa,Ganeshman Charnath ,9400,8139,44900,21982,22918
180,Dhanusa,Hansapur ,8958,7336,44929,21997,22932
181,Dhanusa,Janaknandani  ,5627,4480,28267,13556,14711
182,Dhanusa,Janakpurdham Sub-Metropolitian City,41941,32612,195438,100417,95021
183,Dhanusa,Kamala ,9160,7332,45477,22103,23374
184,Dhanusa,Lakshminiya  ,6609,5409,33212,16161,17051
185,Dhanusa,Mithila Bihari ,7651,6094,38008,18830,19178
186,Dhanusa,Mithila ,10522,9159,47408,23715,23693
187,Dhanusa,Mukhiyapatti Musarmiya  ,5585,4467,29351,14937,14414
188,Dhanusa,Nagarain ,7962,6426,37949,18682,19267
189,Dhanusa,Sabaila ,12279,10144,62510,30630,31880
190,Dhanusa,Sahidnagar ,11288,8944,53546,26387,27159
191,Mahottari,Aurahi ,7841,6376,40834,20496,20338
192,Mahottari,Balwa ,10052,8139,50031,24606,25425
193,Mahottari,Bardibas ,15938,13635,68353,34179,34174
194,Mahottari,Bhangaha ,11336,9017,56570,27508,29062
195,Mahottari,Ekdanra  ,6000,4735,32060,16099,15961
196,Mahottari,Gaushala ,16090,13367,73008,36367,36641
197,Mahottari,Jaleswor ,13685,10607,63501,31620,31881
198,Mahottari,Loharpatti ,9627,7658,46336,22359,23977
199,Mahottari,Mahottari  ,6845,5430,32652,16211,16441
200,Mahottari,Manra Siswa ,9343,7691,49126,24418,24708
201,Mahottari,Matihani ,7356,5748,36063,17620,18443
202,Mahottari,Pipra  ,8514,6459,39500,19764,19736
203,Mahottari,Ramgopalpur ,6921,5630,36594,18240,18354
204,Mahottari,Samsi  ,7100,5478,38676,18818,19858
205,Mahottari,Sonama  ,9252,7524,51736,26647,25089
206,Sarlahi,Bagmati ,10785,9960,45459,22454,23005
207,Sarlahi,Balara ,9118,6760,47602,24635,22967
208,Sarlahi,Barahathawa ,16257,13540,83257,42271,40986
209,Sarlahi,Basbariya  ,4675,3908,26406,13495,12911
210,Sarlahi,Bishnu  ,4784,3587,25870,13350,12520
211,Sarlahi,Bramhapuri  ,5383,4048,27878,13831,14047
212,Sarlahi,Chakraghatta  ,5041,4150,29166,15057,14109
213,Sarlahi,Chandranagar  ,6808,5320,37517,19111,18406
214,Sarlahi,Dhankaul  ,5121,4077,28500,14688,13812
215,Sarlahi,Godaita ,9510,7919,54346,27841,26505
216,Sarlahi,Haripur ,8445,7041,43609,21546,22063
217,Sarlahi,Haripurwa ,6854,5210,36523,18469,18054
218,Sarlahi,Hariwan ,11120,9984,51333,25283,26050
219,Sarlahi,Ishworpur ,13776,11907,68626,34124,34502
220,Sarlahi,Kabilasi ,8150,6702,44688,22487,22201
221,Sarlahi,Kaudena  ,5805,4478,29226,14638,14588
222,Sarlahi,Lalbandi ,15960,13905,67507,33555,33952
223,Sarlahi,Malangawa ,10305,7918,53204,27167,26037
224,Sarlahi,Parsa  ,4656,3625,24039,12262,11777
225,Sarlahi,Ramnagar  ,5853,4373,31687,16335,15352
226,Rautahat,Baudhimai ,6091,4899,39348,20260,19088
227,Rautahat,Brindaban ,8237,6751,50144,24994,25150
228,Rautahat,Chandrapur ,17237,15034,83350,41245,42105
229,Rautahat,Dewahhi Gonahi ,6340,4990,38808,19561,19247
230,Rautahat,Durga Bhagwati  ,4136,3369,23226,11809,11417
231,Rautahat,Gadhimai ,7850,6306,49642,25191,24451
232,Rautahat,Garuda ,9765,7796,60009,30685,29324
233,Rautahat,Gaur ,7743,6062,40368,20655,19713
234,Rautahat,Gujara ,9682,7989,54089,26391,27698
235,Rautahat,Ishanath ,8084,6289,53402,26821,26581
236,Rautahat,Katahariya ,7789,5933,47455,24148,23307
237,Rautahat,Madhav Narayan ,7081,5575,40974,20953,20021
238,Rautahat,Maulapur ,5428,4164,32468,16702,15766
239,Rautahat,Paroha ,7214,5656,46749,23068,23681
240,Rautahat,Phatuwa Bijayapur ,7777,6323,44358,21882,22476
241,Rautahat,Rajdevi ,5919,4600,33836,16923,16913
242,Rautahat,Rajpur ,8254,6205,54372,26939,27433
243,Rautahat,Yemunamai  ,4728,3622,28607,14042,14565
244,Bara,Adarshkotwal  ,5196,4217,29586,15141,14445
245,Bara,Baragadhi  ,5118,4071,29836,15164,14672
246,Bara,Bishrampur  ,4310,3678,23891,12535,11356
247,Bara,Devtal  ,3936,3143,25082,13388,11694
248,Bara,Jitpur Simara Sub-Metropolitian City,23677,19848,119148,60461,58687
249,Bara,Kalaiya Sub-Metropolitian City,23760,19810,141179,72540,68639
250,Bara,Karaiyamai  ,5154,4026,29045,14583,14462
251,Bara,Kolhabi ,11495,9728,46200,22362,23838
252,Bara,Mahagadhimai ,9952,8020,59744,30717,29027
253,Bara,Nijgadh ,8455,7931,36591,18006,18585
254,Bara,Pacharauta ,6402,5128,40252,20468,19784
255,Bara,Parwanipur  ,3664,2975,22466,11767,10699
256,Bara,Pheta  ,5195,4414,28922,14888,14034
257,Bara,Prasauni  ,3400,2924,21747,11146,10601
258,Bara,Simraungadh ,9064,7645,53103,27378,25725
259,Bara,Suwarna  ,5584,4743,35875,18528,17347
260,Parsa,Bahudaramai ,7058,5721,43780,22801,20979
261,Parsa,Bindabasini  ,3832,3210,24466,12637,11829
262,Parsa,Birgunj Metropolitian City,47218,36697,268273,139849,128424
263,Parsa,Chhipaharmai  ,4316,3698,26742,13732,13010
264,Parsa,Dhobini  ,3585,3063,22846,11803,11043
265,Parsa,Jagarnathpur  ,5846,4960,32737,16537,16200
266,Parsa,Jirabhawani  ,5287,4280,22602,11200,11402
267,Parsa,Kalikamai  ,3788,3099,23740,12232,11508
268,Parsa,Pakahamainpur  ,3825,3406,22957,12073,10884
269,Parsa,Parsagadhi ,8002,6653,41477,21023,20454
270,Parsa,Paterwasugauli  ,4850,3851,25508,12866,12642
271,Parsa,Pokhariya ,6614,5504,38985,20285,18700
272,Parsa,SakhuwaPrasauni  ,6382,5244,35712,17890,17822
273,Parsa,Thori  ,4546,4333,17494,8346,9148
274,Sindhuli,Dudhouli ,16231,14869,70679,34227,36452
275,Sindhuli,Ghanglekh  ,2875,2801,12701,6214,6487
276,Sindhuli,Golanjor  ,4537,4340,19012,9296,9716
277,Sindhuli,Hariharpurgadhi  ,5298,5199,26829,13132,13697
278,Sindhuli,Kamalamai ,18238,15913,71811,34922,36889
279,Sindhuli,Marin  ,6089,5843,28988,14277,14711
280,Sindhuli,Phikkal  ,3091,3039,14359,7058,7301
281,Sindhuli,Sunkoshi  ,5075,4920,18136,8772,9364
282,Sindhuli,Tinpatan  ,7939,7669,35145,17429,17716
283,Ramechhap,Doramba  ,5036,4928,17529,8129,9400
284,Ramechhap,Gokulganga  ,4897,4773,18363,8826,9537
285,Ramechhap,Khadadevi  ,5507,5392,19381,9174,10207
286,Ramechhap,Likhu Tamakoshi  ,5310,5149,18675,8702,9973
287,Ramechhap,Manthali ,11105,10212,40230,18967,21263
288,Ramechhap,Ramechhap ,6663,6456,25117,11829,13288
289,Ramechhap,Sunapati  ,4201,4100,14616,6932,7684
290,Ramechhap,Umakunda  ,4216,4063,16709,8219,8490
291,Dolakha,Baiteshwor  ,5412,5212,17947,8613,9334
292,Dolakha,Bhimeshwor ,10265,9049,35122,16895,18227
293,Dolakha,Bigu  ,5055,4805,16299,7853,8446
294,Dolakha,Gaurishankar  ,4667,4612,15982,7889,8093
295,Dolakha,Jiri ,4102,3959,15500,7530,7970
296,Dolakha,Kalinchok  ,6268,6046,21210,10354,10856
297,Dolakha,Melung  ,4877,4759,16051,7571,8480
298,Dolakha,Sailung  ,5248,5088,18328,9048,9280
299,Dolakha,Tamakoshi  ,4759,4317,15237,7369,7868
300,Sindhupalchok,Barhabise ,6994,6677,24158,11980,12178
301,Sindhupalchok,Balefi  ,4730,4467,16465,8062,8403
302,Sindhupalchok,Bhotekoshi  ,3769,3622,14239,7259,6980
303,Sindhupalchok,Chautara SangachokGadhi ,11936,11111,42962,20356,22606
304,Sindhupalchok,Helambu  ,4755,4589,17723,8907,8816
305,Sindhupalchok,Indrawati  ,6812,6584,25518,12114,13404
306,Sindhupalchok,Jugal  ,4698,4549,19148,9657,9491
307,Sindhupalchok,Lisangkhu Pakhar  ,3746,3605,11560,5713,5847
308,Sindhupalchok,Melamchi ,11349,10811,41170,20073,21097
309,Sindhupalchok,Panchpokhari Thangpal  ,5917,5634,20978,10596,10382
310,Sindhupalchok,Sunkoshi  ,4597,4509,15307,7376,7931
311,Sindhupalchok,Tripurasundari  ,3653,3551,12194,5972,6222
312,Kavrepalanchok,Banepa ,16973,12545,67629,33180,34449
313,Kavrepalanchok,Bethanchowk  ,3900,3730,14996,7229,7767
314,Kavrepalanchok,Bhumlu  ,4524,4407,15858,7607,8251
315,Kavrepalanchok,Chaurideurali  ,4181,4084,14106,6668,7438
316,Kavrepalanchok,Dhulikhel ,8808,7309,36183,18501,17682
317,Kavrepalanchok,Khanikhola  ,2484,2455,12375,6131,6244
318,Kavrepalanchok,Mahabharat  ,3327,3297,16148,7933,8215
319,Kavrepalanchok,Mandandeupur ,8220,7861,31261,15335,15926
320,Kavrepalanchok,Namobuddha ,7406,6988,26280,12579,13701
321,Kavrepalanchok,Panauti ,12986,11555,52078,25457,26621
322,Kavrepalanchok,Panchkhal ,9295,8783,35992,17471,18521
323,Kavrepalanchok,Roshi  ,6148,6039,23551,11458,12093
324,Kavrepalanchok,Temal  ,4930,4872,16959,8197,8762
325,Lalitpur,Bagmati  ,2800,2735,11196,5637,5559
326,Lalitpur,Godawari ,24771,20966,100972,49707,51265
327,Lalitpur,Konjyosom  ,2176,2148,9042,4499,4543
328,Lalitpur,Lalitpur Metropolitian City,77872,49044,299843,150702,149141
329,Lalitpur,Mahalaxmi ,31509,20659,118710,60388,58322
330,Lalitpur,Mahankal  ,1878,1836,7861,3913,3948
331,Bhaktapur,Bhaktapur ,18854,12200,78854,39664,39190
332,Bhaktapur,Changunarayan ,21946,17373,88612,44073,44539
333,Bhaktapur,Madhyapur Thimi ,31768,17639,119955,60954,59001
334,Bhaktapur,Suryabinayak ,35885,23637,137971,68971,69000
335,Kathmandu,Budhanilakantha ,47169,26910,179688,89284,90404
336,Kathmandu,Chandragiri ,36012,22070,136928,68350,68578
337,Kathmandu,Dakshinkali ,6527,5568,26744,13179,13565
338,Kathmandu,Gokarneshwor ,40114,19098,151200,74453,76747
339,Kathmandu,Kageshwori Manahora ,34794,21028,133327,66138,67189
340,Kathmandu,Kathmandu Metropolitian City,231714,105649,845767,431501,414266
341,Kathmandu,Kirtipur ,24211,12676,81782,43378,38404
342,Kathmandu,Nagarjun ,31323,17466,115507,57631,57876
343,Kathmandu,Shankharapur ,7275,6479,30414,15188,15226
344,Kathmandu,Tarakeshwor ,41364,21623,151508,75300,76208
345,Kathmandu,Tokha ,37413,17239,135741,67396,68345
346,Nuwakot,Belkotgadhi ,9464,9244,35200,17139,18061
347,Nuwakot,Bidur ,15604,13911,60111,29043,31068
348,Nuwakot,Dupcheshwar  ,5195,5023,21019,10473,10546
349,Nuwakot,Kakani  ,6388,6012,24323,11969,12354
350,Nuwakot,Kispang  ,3969,3853,14122,6920,7202
351,Nuwakot,Likhu  ,4604,4374,17737,8646,9091
352,Nuwakot,Myagang  ,3755,3595,12417,6086,6331
353,Nuwakot,Panchakanya  ,3629,3539,13864,6771,7093
354,Nuwakot,Shivapuri  ,4877,4795,16979,8115,8864
355,Nuwakot,Suryagadhi  ,3842,3776,14929,7256,7673
356,Nuwakot,Tadi  ,4031,3867,16055,7911,8144
357,Nuwakot,Tarkeshwar  ,3792,3735,14164,6670,7494
358,Rasuwa,Gosaikunda  ,2477,2149,8043,4071,3972
359,Rasuwa,Kalika  ,2474,2412,10172,5011,5161
360,Rasuwa,Naukunda  ,2899,2878,12095,6059,6036
361,Rasuwa,Amachodingmo  ,1727,1688,6673,3486,3187
362,Rasuwa,Uttargaya  ,2264,2235,8571,4232,4339
363,Dhading,Benighat Rorang  ,7791,6979,34473,17542,16931
364,Dhading,Dhunibesi ,7235,6777,29126,14411,14715
365,Dhading,Gajuri  ,6909,6306,28756,14471,14285
366,Dhading,Galchi  ,6212,5783,24206,11875,12331
367,Dhading,Gangajamuna  ,5305,5183,19460,9494,9966
368,Dhading,Jwalamukhi  ,6116,5972,21202,9898,11304
369,Dhading,Khaniyabash  ,2640,2618,10680,5175,5505
370,Dhading,Netrawati Dabjong  ,3295,3242,11271,5390,5881
371,Dhading,Nilakantha ,16579,14281,58151,27136,31015
372,Dhading,Rubi Valley  ,3005,2989,10472,5261,5211
373,Dhading,Siddhalek  ,5883,5795,22212,10652,11560
374,Dhading,Thakre  ,7745,7142,31554,15797,15757
375,Dhading,Tripura Sundari  ,5748,5596,21188,10105,11083
376,Makwanpur,Bagmati  ,6498,6195,30625,15111,15514
377,Makwanpur,Bakaiya  ,9028,8664,40671,19947,20724
378,Makwanpur,Bhimphedi  ,5128,4939,21626,10668,10958
379,Makwanpur,Hetauda Sub-Metropolitian City,47027,39425,195951,97324,98627
380,Makwanpur,Indrasarowar  ,3415,3217,13758,6739,7019
381,Makwanpur,Kailash  ,4487,4400,21992,11140,10852
382,Makwanpur,Makawanpurgadhi  ,5342,5239,24252,12169,12083
383,Makwanpur,Manahari  ,10762,10097,47144,22986,24158
384,Makwanpur,Raksirang  ,5077,5043,25871,13147,12724
385,Makwanpur,Thaha ,9842,8995,39163,19241,19922
386,Chitawan,Bharatpur Metropolitian City,98288,77838,369377,179744,189633
387,Chitawan,Ichchhyakamana  ,6174,5517,26965,13599,13366
388,Chitawan,Kalika ,12466,11623,52779,25740,27039
389,Chitawan,Khairahani ,16757,14650,68675,33104,35571
390,Chitawan,Madi ,10227,9710,38550,18257,20293
391,Chitawan,Rapti ,15459,14390,66426,32609,33817
392,Chitawan,Ratnanagar ,22670,19901,90978,44120,46858
393,Gorkha,Aarughat  ,6220,5950,21876,10409,11467
394,Gorkha,Ajirkot  ,3667,3589,13002,6389,6613
395,Gorkha,Bhimsenthapa  ,5265,5186,17118,7819,9299
396,Gorkha,Chum Nubri  ,2134,2036,6789,3240,3549
397,Gorkha,Dharche  ,3790,3683,14563,7025,7538
398,Gorkha,Gandaki  ,5688,5537,21662,10414,11248
399,Gorkha,Gorkha ,15298,12641,53285,25279,28006
400,Gorkha,Palungtar ,11317,10727,37274,17431,19843
401,Gorkha,Sahid Lakhan  ,6812,6554,22429,10492,11937
402,Gorkha,Siranchok  ,6026,5907,19829,9352,10477
403,Gorkha,Barpak Sulikot  ,6583,6426,23222,10921,12301
404,Lamjung,Besishahar ,11308,8781,38562,18525,20037
405,Lamjung,Dordi  ,4597,4462,15639,7585,8054
406,Lamjung,Dudhpokhari  ,2492,2470,8558,4178,4380
407,Lamjung,Kwholasothar  ,2285,2228,8008,3827,4181
408,Lamjung,MadhyaNepal ,6528,6002,21373,9767,11606
409,Lamjung,Marsyangdi  ,4620,4455,17267,8421,8846
410,Lamjung,Rainas ,5009,4872,17207,8309,8898
411,Lamjung,Sundarbazar ,8034,6831,26866,12597,14269
412,Tanahu,Anbukhaireni  ,6284,4758,22349,10791,11558
413,Tanahu,Bandipur  ,5418,4712,19403,9251,10152
414,Tanahu,Bhanu ,13064,12351,43255,19943,23312
415,Tanahu,Bhimad ,8964,7965,33077,15166,17911
416,Tanahu,Byas ,24078,19547,80944,37669,43275
417,Tanahu,Devghat  ,3878,3653,14941,7115,7826
418,Tanahu,Ghiring  ,4490,4102,15038,7013,8025
419,Tanahu,Myagde  ,6532,5857,23385,10781,12604
420,Tanahu,Rhishing  ,4981,4611,18821,8590,10231
421,Tanahu,Shuklagandaki ,15479,14086,55749,26023,29726
422,Syangja,Aandhikhola  ,4718,4278,14970,6916,8054
423,Syangja,Arjunchaupari  ,3810,3549,14094,6495,7599
424,Syangja,Bhirkot ,6226,5644,22617,10320,12297
425,Syangja,Biruwa  ,3980,3775,13900,6571,7329
426,Syangja,Chapakot ,6389,5726,22787,10398,12389
427,Syangja,Galyang ,7971,7226,31125,14413,16712
428,Syangja,Harinas  ,3591,3318,12979,5953,7026
429,Syangja,Kaligandagi  ,4946,4666,18008,8242,9766
430,Syangja,Phedikhola  ,3222,2919,10786,5035,5751
431,Syangja,Putalibazar ,12152,10390,42079,19440,22639
432,Syangja,Waling ,13705,11365,50932,23657,27275
433,Kaski,Annapurna  ,6406,5811,22517,10863,11654
434,Kaski,Machhapuchchhre  ,6144,5509,22013,10762,11251
435,Kaski,Madi  ,4115,4014,16318,8136,8182
436,Kaski,Pokhara Metropolitian City,143137,101669,518452,250999,267453
437,Kaski,Rupa  ,3674,3569,14741,7093,7648
438,Manang,Chame  ,391,333,1272,728,544
439,Manang,Narpa Bhumi  ,125,125,398,170,228
440,Manang,Narshon  ,471,441,1671,831,840
441,Manang,Manang Ingshyang  ,558,548,1584,818,766
442,Mustang,Waragung Muktikhsetra  ,738,666,2611,1336,1275
443,Mustang,Lo-Ghekar Damodarkunda  ,459,444,1535,748,787
444,Mustang,Gharapjhong  ,1169,921,4875,2904,1971
445,Mustang,Lomanthang  ,540,539,1997,1132,865
446,Mustang,Thasang  ,845,698,3578,2054,1524
447,Myagdi,Annapurna  ,3618,3340,12351,6078,6273
448,Myagdi,Beni ,9465,7202,33062,15572,17490
449,Myagdi,Dhaulagiri  ,3192,3008,12604,6158,6446
450,Myagdi,Malika  ,4818,4336,18346,8999,9347
451,Myagdi,Mangala  ,3934,3699,14772,7030,7742
452,Myagdi,Raghuganga  ,4174,3767,14232,6857,7375
453,Parbat,Bihadi  ,3192,3063,12521,5960,6561
454,Parbat,Jaljala  ,6095,5140,21375,10259,11116
455,Parbat,Kushma ,11906,9740,38774,18543,20231
456,Parbat,Mahashila  ,2093,1964,8233,3867,4366
457,Parbat,Modi  ,5148,4618,18018,8611,9407
458,Parbat,Painyu  ,3292,2995,12705,6025,6680
459,Parbat,Phalebas ,5875,5529,20726,9534,11192
460,Baglung,Badigad  ,6819,6324,28797,13487,15310
461,Baglung,Baglung ,16399,12924,57030,26588,30442
462,Baglung,Bareng  ,2981,2796,11162,5070,6092
463,Baglung,Dhorpatan ,7661,6535,30779,14306,16473
464,Baglung,Galkot ,7912,7314,30503,14473,16030
465,Baglung,Jaimuni ,6912,6555,24784,11310,13474
466,Baglung,Kanthekhola  ,5961,5743,22732,10387,12345
467,Baglung,Nisikhola  ,5711,5499,23215,10566,12649
468,Baglung,Taman Khola  ,2622,2453,9795,4667,5128
469,Baglung,Tara Khola  ,2356,2302,10167,5010,5157
470,Nawalparasi East,Binayee Tribeni  ,9348,8651,39201,18664,20537
471,Nawalparasi East,Bulingtar  ,3569,3305,14596,7007,7589
472,Nawalparasi East,Baudeekali  ,2914,2676,11339,5164,6175
473,Nawalparasi East,Devchuli ,14836,13127,59400,28133,31267
474,Nawalparasi East,Gaidakot ,20701,17151,80737,38725,42012
475,Nawalparasi East,Hupsekot  ,6250,5865,26861,12346,14515
476,Nawalparasi East,Kawasoti ,22184,19568,87176,40890,46286
477,Nawalparasi East,Madhyabindu ,15549,14345,61548,28291,33257
478,Gulmi,Chandrakot  ,5148,4732,18751,8605,10146
479,Gulmi,Chatrakot  ,5320,5073,19239,8601,10638
480,Gulmi,Dhurkot  ,5405,5036,18699,8285,10414
481,Gulmi,Gulmidarbar  ,5288,5032,19413,8490,10923
482,Gulmi,Isma  ,5013,4777,18530,8453,10077
483,Gulmi,Kaligandaki  ,3793,3640,15106,7085,8021
484,Gulmi,Madane  ,5274,4961,19820,8985,10835
485,Gulmi,Malika  ,5273,5040,20173,9263,10910
486,Gulmi,Musikot ,7135,6761,28761,13371,15390
487,Gulmi,Resunga ,9129,6865,31677,14696,16981
488,Gulmi,Ruru  ,4691,4348,16638,7627,9011
489,Gulmi,Satyawati  ,5252,4953,19751,9056,10695
490,Palpa,Bagnaskali  ,4648,4423,16934,7683,9251
491,Palpa,Mathagadhi  ,5840,5553,24024,11222,12802
492,Palpa,Nisdi  ,4075,3772,17629,8137,9492
493,Palpa,Purbakhola  ,4138,3660,16145,7147,8998
494,Palpa,Rainadevi Chhahara  ,6390,6046,23124,10491,12633
495,Palpa,Rambha  ,4696,4339,17077,7565,9512
496,Palpa,Rampur ,10821,9111,39190,17775,21415
497,Palpa,Ribdikot  ,4459,4236,15636,7195,8441
498,Palpa,Tansen ,14865,10919,51470,23927,27543
499,Palpa,Tinau  ,4326,4164,18291,8628,9663
500,Nawalparasi West,Bardaghat ,18240,16430,75017,35180,39837
501,Nawalparasi West,Palhi Nandan  ,7383,6165,40325,20662,19663
502,Nawalparasi West,Pratappur  ,10753,9234,50326,25016,25310
503,Nawalparasi West,Ramgram ,13081,11037,64150,31842,32308
504,Nawalparasi West,Sarawal  ,8840,7576,42217,20691,21526
505,Nawalparasi West,Sunwal ,17689,15871,72621,34316,38305
506,Nawalparasi West,Susta  ,7892,6946,39798,19365,20433
507,Rupandehi,Butwal Sub-Metropolitian City,51099,36989,195054,95705,99349
508,Rupandehi,Devdaha ,17582,15624,71806,33747,38059
509,Rupandehi,Gaidahawa  ,10020,8612,56529,28000,28529
510,Rupandehi,Kanchan  ,10483,9828,42528,19295,23233
511,Rupandehi,Kotahimai  ,7921,5939,46417,23527,22890
512,Rupandehi,Lumbini Sanskritik ,13854,10736,88090,43706,44384
513,Rupandehi,Marchawari  ,6972,5305,41058,20632,20426
514,Rupandehi,Mayadevi  ,10040,8003,57341,28991,28350
515,Rupandehi,Omsatiya  ,8218,6683,41080,20332,20748
516,Rupandehi,Rohini  ,8096,6349,43277,21836,21441
517,Rupandehi,Sainamaina ,19657,17572,78477,36547,41930
518,Rupandehi,Sammarimai  ,7303,5164,43300,21691,21609
519,Rupandehi,Siddharthanagar ,16011,12329,76307,38136,38171
520,Rupandehi,Siyari  ,9060,7883,45274,22100,23174
521,Rupandehi,Sudhdhodhan  ,8717,7619,41472,20352,21120
522,Rupandehi,Tillotama ,36399,30452,149657,71700,77957
523,Kapilbastu,Banganga ,23482,21157,97114,45820,51294
524,Kapilbastu,Bijayanagar  ,7144,6361,43440,21562,21878
525,Kapilbastu,Buddhabhumi ,15581,13717,77281,37580,39701
526,Kapilbastu,Kapilbastu ,15555,12871,89969,44505,45464
527,Kapilbastu,Krishnanagar ,10889,8734,70969,35449,35520
528,Kapilbastu,Maharajgunj ,9945,8084,65668,33257,32411
529,Kapilbastu,Mayadevi  ,8383,6623,57121,28014,29107
530,Kapilbastu,Shivaraj ,16072,13960,84454,41098,43356
531,Kapilbastu,Suddhodhan  ,8593,6770,53417,26258,27159
532,Kapilbastu,Yashodhara  ,7045,5462,45169,22030,23139
533,Arghakhanchi,Bhumekasthan ,7891,7403,28317,12687,15630
534,Arghakhanchi,Chhatradev  ,6263,5930,21691,9676,12015
535,Arghakhanchi,Malarani  ,6842,6501,23780,10747,13033
536,Arghakhanchi,Panini  ,6214,5915,22330,10064,12266
537,Arghakhanchi,Sandhikharka ,12322,10261,42528,19507,23021
538,Arghakhanchi,Sitganga ,9541,9002,37888,17787,20101
539,Pyuthan,Ayirabati  ,5145,4628,20404,9074,11330
540,Pyuthan,Gaumukhi  ,5616,5380,26000,12006,13994
541,Pyuthan,Jhimruk  ,6592,6130,26491,11935,14556
542,Pyuthan,Mallarani  ,4152,3743,15846,6866,8980
543,Pyuthan,Mandavi  ,3904,3469,15778,7005,8773
544,Pyuthan,Naubahini  ,7163,6781,32524,14916,17608
545,Pyuthan,Pyuthan ,11500,10175,42094,18945,23149
546,Pyuthan,Sarumarani  ,4488,4125,19370,8545,10825
547,Pyuthan,Sworgadwary ,8400,7739,32127,14041,18086
548,Rolpa,Pariwartan  ,4765,4567,22001,10252,11749
549,Rolpa,Lungri  ,5668,5486,26539,12348,14191
550,Rolpa,Madi  ,4143,4023,18013,8431,9582
551,Rolpa,Rolpa ,8836,7464,35644,16410,19234
552,Rolpa,Runtigadi  ,6387,6055,29094,13734,15360
553,Rolpa,Sunil Smriti  ,7066,6462,30523,13983,16540
554,Rolpa,Gangadev  ,4474,4423,21738,10278,11460
555,Rolpa,Sunchhahari  ,3607,3505,17281,8298,8983
556,Rolpa,Thawang  ,2575,2345,11008,5159,5849
557,Rolpa,Tribeni  ,5468,5257,23190,10941,12249
558,Rukum East,Bhume  ,4194,3849,19835,9425,10410
559,Rukum East,Putha Uttarganga  ,4573,3925,18954,9473,9481
560,Rukum East,Sisne  ,4396,3833,18751,9122,9629
561,Dang,Babai  ,7538,7171,31317,14527,16790
562,Dang,Banglachuli  ,5173,4951,22877,10276,12601
563,Dang,Dangisharan  ,5897,5579,23672,11436,12236
564,Dang,Gadhawa  ,10084,9448,46275,22650,23625
565,Dang,Ghorahi Sub-Metropolitian City,51619,45240,201079,94384,106695
566,Dang,Lamahi ,13862,12482,58884,28257,30627
567,Dang,Rajpur  ,5896,5634,28410,14171,14239
568,Dang,Rapti  ,11837,10940,52158,24720,27438
569,Dang,Shantinagar  ,7137,6792,27666,12872,14794
570,Dang,Tulsipur Sub-Metropolitian City,46699,41012,180734,85701,95033
571,Banke,Baijanath  ,16765,15439,70315,32739,37576
572,Banke,Duduwa  ,8112,6152,43039,21798,21241
573,Banke,Janki  ,9124,7263,46536,23386,23150
574,Banke,Khajura  ,13885,12213,63749,30284,33465
575,Banke,Kohalpur ,24346,21251,100289,48324,51965
576,Banke,Narainapur  ,8680,6941,43698,21822,21876
577,Banke,Nepalgunj Sub-Metropolitian City,35517,26491,166258,83311,82947
578,Banke,Rapti Sonari  ,15491,14380,67782,32015,35767
579,Bardiya,Badhaiyatal  ,12736,11826,52056,24042,28014
580,Bardiya,Bansagadhi ,15149,13965,63400,29486,33914
581,Bardiya,Barbardiya ,16950,15852,72892,34353,38539
582,Bardiya,Geruwa  ,7788,7613,33742,15525,18217
583,Bardiya,Gulariya ,16141,14177,74868,37086,37782
584,Bardiya,Madhuwan ,12474,11647,51173,23570,27603
585,Bardiya,Rajapur ,13711,13191,61431,29166,32265
586,Bardiya,Thakurbaba ,11480,10646,49360,22853,26507
587,Rukum West,Aathbiskot ,7603,7094,35929,17743,18186
588,Rukum West,Banfikot  ,4827,4398,20940,10085,10855
589,Rukum West,Chaurjahari ,6791,5957,29255,14170,15085
590,Rukum West,Musikot ,8793,7425,33871,16091,17780
591,Rukum West,Sani Bheri  ,5313,4897,24778,12152,12626
592,Rukum West,Tribeni  ,4375,4231,20466,9775,10691
593,Salyan,Bagchaur ,7539,7212,34053,16496,17557
594,Salyan,Bangad Kupinde ,7893,7423,33758,16237,17521
595,Salyan,Chhatreshwori  ,5135,4847,21368,10115,11253
596,Salyan,Darma  ,4270,4006,19998,9699,10299
597,Salyan,Siddha Kumakh  ,2892,2786,13135,6274,6861
598,Salyan,Kalimati  ,4994,4734,22498,11126,11372
599,Salyan,Kapurkot  ,3978,3864,17548,8410,9138
600,Salyan,Kumakh  ,5582,5149,24858,12088,12770
601,Salyan,Sharada ,8992,8122,34684,16516,18168
602,Salyan,Tribeni  ,4125,3841,16768,7992,8776
603,Surkhet,Barahtal  ,6240,6059,25562,12248,13314
604,Surkhet,Bheriganga ,11599,10524,48581,22833,25748
605,Surkhet,Birendranagar ,39391,31847,154886,75921,78965
606,Surkhet,Chaukune  ,5358,4897,27006,13289,13717
607,Surkhet,Chingad  ,3240,3066,15752,7405,8347
608,Surkhet,Gurbhakot ,11923,10960,49394,23162,26232
609,Surkhet,Lekbeshi ,7475,7134,31791,14978,16813
610,Surkhet,Panchpuri ,7979,7326,36062,17530,18532
611,Surkhet,Simta  ,6121,5475,24298,10740,13558
612,Dailekh,Aathabis ,6246,4951,31839,15565,16274
613,Dailekh,Bhagawatimai  ,3627,3344,18366,9083,9283
614,Dailekh,Bhairabi  ,4198,3755,17981,8377,9604
615,Dailekh,Chamunda Bindrasaini ,5192,4475,26575,13044,13531
616,Dailekh,Dullu ,9208,8353,39582,18506,21076
617,Dailekh,Dungeshwor  ,3436,3163,14597,6940,7657
618,Dailekh,Gurans  ,4562,4358,21284,10483,10801
619,Dailekh,Mahabu  ,4021,3652,18037,8316,9721
620,Dailekh,Narayan ,6668,5421,25803,12222,13581
621,Dailekh,Naumule  ,4517,4162,20589,10032,10557
622,Dailekh,Thantikandh  ,4033,3142,18666,9107,9559
623,Jajarkot,Barekot  ,3901,3485,22038,11010,11028
624,Jajarkot,Bheri ,8962,7745,38370,18636,19734
625,Jajarkot,Chhedagad ,7431,6888,38027,18852,19175
626,Jajarkot,Junichande  ,4356,3967,23823,11979,11844
627,Jajarkot,Kuse  ,4520,4199,23529,11636,11893
628,Jajarkot,Shiwalaya  ,2820,2598,14720,7270,7450
629,Jajarkot,Nalagad ,6064,5427,28858,14412,14446
630,Dolpa,Chharka Tangsong  ,320,306,1713,839,874
631,Dolpa,Dolpo Buddha  ,543,542,2462,1206,1256
632,Dolpa,Jagadulla  ,600,511,2581,1289,1292
633,Dolpa,Kaike  ,926,715,4124,1931,2193
634,Dolpa,Mudkechula  ,1206,1078,5875,2975,2900
635,Dolpa,Shey Phoksundo  ,818,805,3717,1775,1942
636,Dolpa,Thuli Bheri ,2380,1770,10187,5113,5074
637,Dolpa,Tripurasundari ,2636,2268,12300,6148,6152
638,Jumla,Chandannath ,5367,4166,20973,10475,10498
639,Jumla,Guthichaur  ,2451,2205,10891,5344,5547
640,Jumla,Hima  ,2104,2062,12804,6388,6416
641,Jumla,Kanakasundari  ,2786,2733,13687,6807,6880
642,Jumla,Patrasi  ,3374,3191,16881,8349,8532
643,Jumla,Sinja  ,2427,2271,12744,6561,6183
644,Jumla,Tatopani  ,3321,3190,15721,7728,7993
645,Jumla,Tila  ,2666,2582,14692,7261,7431
646,Kalikot,Subha Kalika  ,2769,2311,13900,6784,7116
647,Kalikot,Khandachakra ,4132,3266,23336,11948,11388
648,Kalikot,Mahawai  ,1666,1364,8334,4072,4262
649,Kalikot,Naraharinath  ,4422,3668,22414,11109,11305
650,Kalikot,Pachaljharana  ,2509,2196,13683,6837,6846
651,Kalikot,Palata  ,2895,2683,17658,9018,8640
652,Kalikot,Raskot ,3076,2836,16469,8059,8410
653,Kalikot,Sanni Tribeni  ,2352,2088,12864,6363,6501
654,Kalikot,Tilagufa ,3135,2517,16259,8053,8206
655,Mugu,Chhayanath Rara ,4917,4529,25692,13022,12670
656,Mugu,Khatyad  ,3567,3429,19301,9840,9461
657,Mugu,Mugum Karmarong  ,1399,1364,7301,3506,3795
658,Mugu,Soru  ,2652,2469,14364,7080,7284
659,Humla,Adanchuli  ,1481,1344,8110,4012,4098
660,Humla,Chankheli  ,1196,1175,6625,3367,3258
661,Humla,Kharpunath  ,1545,1330,6975,3465,3510
662,Humla,Namkha  ,868,850,4506,2304,2202
663,Humla,Sarkegad  ,2211,2016,11040,5669,5371
664,Humla,Simkot  ,3007,2512,12130,6101,6029
665,Humla,Tanjakot  ,1176,1086,6110,3064,3046
666,Bajura,Badimalika ,4082,3143,18432,9253,9179
667,Bajura,Budhiganga ,4680,3875,20072,9259,10813
668,Bajura,Budhinanda ,4317,3195,20745,10214,10531
669,Bajura,Khaptad Chhededaha  ,3627,2878,19274,9326,9948
670,Bajura,Gaumul  ,1731,1588,8765,4373,4392
671,Bajura,Himali  ,2092,1716,10503,5284,5219
672,Bajura,Jagannath  ,1965,1687,10205,4938,5267
673,Bajura,Swami Kartik Khaapar  ,2392,2242,13013,6593,6420
674,Bajura,Tribeni ,4036,3567,17989,8368,9621
675,Bajhang,Bithadchir  ,3273,2728,16854,8301,8553
676,Bajhang,Bungal ,6242,5357,33487,15885,17602
677,Bajhang,Chabispathivera  ,3125,2792,14515,6770,7745
678,Bajhang,Durgathali  ,2606,2282,11414,5149,6265
679,Bajhang,JayaPrithivi ,5034,4088,21973,10560,11413
680,Bajhang,SaiPaal  ,456,454,2681,1330,1351
681,Bajhang,Kedarseu  ,4389,3768,21697,10000,11697
682,Bajhang,Khaptadchhanna  ,3100,2453,13751,6238,7513
683,Bajhang,Masta  ,2608,2519,13584,6518,7066
684,Bajhang,Surma  ,1835,1593,11248,5609,5639
685,Bajhang,Talkot  ,2238,2063,11858,5454,6404
686,Bajhang,Thalara  ,3462,2819,15961,7104,8857
687,Achham,Bannigadhi Jayagadh  ,3144,2309,13639,5887,7752
688,Achham,Chaurpati  ,4822,3960,22407,9985,12422
689,Achham,Dhakari  ,4373,3501,22553,10813,11740
690,Achham,Kamalbazar ,4590,3730,20947,9480,11467
691,Achham,Mangalsen ,6231,4587,26843,12101,14742
692,Achham,Mellekh  ,4752,3628,23096,10670,12426
693,Achham,Panchadewal Binayak ,5432,4466,26316,12062,14254
694,Achham,Ramaroshan  ,4959,3876,22676,10759,11917
695,Achham,Sanphebagar ,6382,4883,25990,11965,14025
696,Achham,Turmakhad  ,5277,4428,24440,11668,12772
697,Doti,Adharsha  ,5449,4204,24911,11141,13770
698,Doti,Badikedar  ,2984,2762,15078,7555,7523
699,Doti,Bogtan Foodsil  ,3198,2774,15912,7488,8424
700,Doti,Dipayal Silgadi ,8601,6111,36906,17884,19022
701,Doti,Jorayal  ,4432,4092,20364,10251,10113
702,Doti,K I Singh  ,4731,3975,20830,9130,11700
703,Doti,Purbichauki  ,5305,4095,21263,9089,12174
704,Doti,Sayal  ,4311,3139,20125,9221,10904
705,Doti,Shikhar ,7089,5654,30294,13307,16987
706,Kailali,Bardagoriya  ,8639,8162,37714,17882,19832
707,Kailali,Bhajani ,11143,10701,53795,25802,27993
708,Kailali,Chure  ,4272,4015,21437,10809,10628
709,Kailali,Dhangadhi Sub-Metropolitian City,46670,39249,204788,102334,102454
710,Kailali,Gauriganga ,13693,12984,64327,29730,34597
711,Kailali,Ghodaghodi ,18636,17796,85982,40223,45759
712,Kailali,Godawari ,21508,19356,99973,47873,52100
713,Kailali,Janaki  ,11180,10657,49835,23202,26633
714,Kailali,Joshipur  ,7775,7630,37167,17788,19379
715,Kailali,Kailari  ,10793,10458,50457,24485,25972
716,Kailali,Lamkichuha ,20801,19367,90941,42795,48146
717,Kailali,Mohanyal  ,4450,4226,21285,10375,10910
718,Kailali,Tikapur ,20953,19091,90115,43354,46761
719,Kanchanpur,Bedkot ,12780,11904,58250,27055,31195
720,Kanchanpur,Beldandi  ,4727,4471,22041,9939,12102
721,Kanchanpur,Belauri ,11154,10296,53918,25526,28392
722,Kanchanpur,Bhimdatta ,27691,24715,123316,59400,63916
723,Kanchanpur,Krishnapur ,15272,14217,72501,34347,38154
724,Kanchanpur,Laljhadi  ,4822,4666,25271,12282,12989
725,Kanchanpur,Dodhara Chandani ,9657,8891,43486,19254,24232
726,Kanchanpur,Punarbas ,13676,12895,61628,28286,33342
727,Kanchanpur,Shuklaphanta ,12120,11316,54379,24948,29431
728,Dadeldhura,Alital  ,3743,3421,18125,8773,9352
729,Dadeldhura,Ajaymeru  ,3479,2987,15243,7167,8076
730,Dadeldhura,Amargadhi ,6385,4752,24792,12515,12277
731,Dadeldhura,Bhageshwar  ,2812,2362,13112,6290,6822
732,Dadeldhura,Ganayapdhura  ,3360,2788,13655,6158,7497
733,Dadeldhura,Nawadurga  ,4335,3634,18745,8194,10551
734,Dadeldhura,Parashuram ,7494,6559,35748,16833,18915
735,Baitadi,Dasharathchanda ,7339,6095,31786,15053,16733
736,Baitadi,Dilasaini  ,4925,3930,23233,11347,11886
737,Baitadi,Dogadakedar  ,4774,3998,23619,10854,12765
738,Baitadi,Melauli ,4626,3890,21000,9735,11265
739,Baitadi,Pancheshwar  ,3617,2986,17780,8130,9650
740,Baitadi,Patan ,6276,5195,28360,13415,14945
741,Baitadi,Purchaudi ,7236,6417,38666,18701,19965
742,Baitadi,Shivanath  ,3435,2919,18247,8489,9758
743,Baitadi,Sigas  ,4367,3652,23479,11153,12326
744,Baitadi,Surnaya  ,3877,3206,18230,8549,9681
745,Darchula,Apihimal  ,1363,1256,7023,3438,3585
746,Darchula,Byas  ,2361,2168,10205,4884,5321
747,Darchula,Dunhu  ,2293,1906,9912,4580,5332
748,Darchula,Lekam  ,3045,2645,13638,6520,7118
749,Darchula,Mahakali ,6080,4596,24572,12072,12500
750,Darchula,Malikaarjun  ,3241,2993,15754,7631,8123
751,Darchula,Marma  ,3086,2704,15586,7551,8035
752,Darchula,Naugad  ,3156,2920,16434,7988,8446
753,Darchula,Shailyashikhar ,4561,4012,21932,10685,11247
